1,1,1,1,1,1,1,21,1,1,1,1,1,1,1,1,1,1,1,1
1,1,1,1,1,1,1,1,1,1,1,1,1,1,1,1,1,1,1,1
1,1,1,1,1,1,1,1,1,1,1,1,1,1,1,1,1,1,1,1
1,1,0,1,1,1,1,1,1,1,1,1,1,1,1,0,1,1,1,1
1,1,1,1,26,1,1,1,1,1,1,1,1,1,1,1,1,1,1,1
1,1,1,1,20,1,1,1,1,1,1,1,1,1,1,1,1,1,1,1
1,1,1,1,20,1,1,1,1,1,1,1,1,1,1,1,1,1,1,1
1,1,1,1,20,1,1,1,1,1,1,1,1,1,1,1,1,1,1,1
1,1,1,1,20,1,1,1,1,1,1,1,1,1,1,1,1,1,1,1
1,1,1,1,20,1,1,1,1,1,1,1,1,1,1,1,1,1,1,1
1,1,1,1,1,1,1,1,1,1,1,1,1,1,1,1,1,1,1,1
0,1,1,1,1,1,1,1,1,1,1,1,1,1,1,1,1,1,1,1
